0000000000000
0000000000000
0010000000000
0010000000000
0010000000000
0011111100000
0000000000000
0000000000000
0000000000000
0000011111111
0000000000100
0011111110100
0001000000100
0001011110100
0001000000100
0001000000100
0000000000000
0000111111111
0000000000001
0000000000010
0000000000010
0000000000100
0010000000100
0011000000100
0001000000100
0001000000010
0001000000010
0001111000001
0000000000000
0000000000000
0000000111000
